//MAP CONVERTED BY dmm2tgm.py THIS HEADER COMMENT PREVENTS RECONVERSION, DO NOT REMOVE
"aE" = (
/obj/structure/stone_tile/center/burnt,
/obj/structure/stone_tile/surrounding_tile/cracked{
	dir = 1
	},
/obj/structure/stone_tile/surrounding/cracked,
/obj/effect/mob_spawn/corpse/human/skeleton,
/turf/open/indestructible/necropolis,
/area/lavaland/surface/outdoors)
"aO" = (
/obj/structure/stone_tile/surrounding_tile/burnt{
	dir = 4
	},
/turf/open/indestructible/necropolis,
/area/ruin/powered/gluttony)
"bv" = (
/obj/structure/stone_tile/block{
	dir = 8
	},
/obj/effect/decal/cleanable/blood/gibs,
/turf/open/indestructible/necropolis,
/area/ruin/powered/gluttony)
"bD" = (
/obj/effect/decal/cleanable/blood/footprints,
/obj/effect/decal/cleanable/blood/tracks{
	dir = 1
	},
/turf/open/indestructible/necropolis,
/area/ruin/powered/gluttony)
"dI" = (
/obj/structure/stone_tile/block,
/obj/structure/stone_tile/slab/cracked{
	dir = 8
	},
/obj/structure/table/wood,
/obj/item/food/meat/slab/human/mutant/lizard,
/obj/item/food/meat/slab/human/mutant/lizard,
/obj/item/food/meat/slab/human/mutant/lizard,
/turf/open/indestructible/necropolis,
/area/ruin/powered/gluttony)
"eb" = (
/obj/structure/stone_tile{
	dir = 4
	},
/obj/structure/table/wood,
/obj/item/food/meat/slab/corgi{
	pixel_x = 3;
	pixel_y = 1
	},
/obj/item/food/meat/slab/corgi{
	pixel_x = 5;
	pixel_y = 5
	},
/obj/item/knife/combat/bone,
/turf/open/indestructible/necropolis,
/area/ruin/powered/gluttony)
"eq" = (
/obj/effect/decal/cleanable/blood/footprints{
	dir = 8
	},
/obj/effect/decal/cleanable/blood/tracks{
	dir = 4
	},
/obj/structure/stone_tile/block,
/turf/open/indestructible/necropolis,
/area/ruin/powered/gluttony)
"eN" = (
/obj/effect/decal/cleanable/blood/footprints{
	dir = 1
	},
/obj/effect/decal/cleanable/blood/tracks{
	dir = 1
	},
/obj/effect/decal/cleanable/blood,
/turf/open/indestructible/necropolis,
/area/ruin/powered/gluttony)
"fa" = (
/obj/structure/table/wood,
/obj/item/food/meat/slab/human,
/obj/structure/stone_tile/block/cracked{
	dir = 8
	},
/obj/structure/stone_tile/surrounding_tile/burnt{
	dir = 1
	},
/turf/open/indestructible/necropolis,
/area/ruin/powered/gluttony)
"fY" = (
/obj/structure/stone_tile/center,
/obj/structure/stone_tile/surrounding_tile{
	dir = 1
	},
/obj/structure/stone_tile/surrounding_tile/burnt,
/obj/structure/stone_tile/surrounding_tile/cracked{
	dir = 8
	},
/turf/open/indestructible/necropolis,
/area/lavaland/surface/outdoors)
"gg" = (
/obj/structure/stone_tile/block/burnt{
	dir = 8
	},
/turf/open/misc/asteroid/basalt/lava_land_surface/biome_replace,
/area/lavaland/surface/outdoors)
"ie" = (
/obj/item/veilrender/vealrender,
/obj/structure/stone_tile/slab/cracked{
	dir = 6
	},
/turf/open/indestructible/necropolis,
/area/ruin/powered/gluttony)
"iw" = (
/obj/effect/decal/cleanable/blood/tracks{
	dir = 5
	},
/turf/open/indestructible/necropolis,
/area/ruin/powered/gluttony)
"jM" = (
/turf/closed/indestructible/necropolis,
/area/ruin/powered/gluttony)
"kB" = (
/obj/structure/stone_tile/slab/cracked{
	dir = 1
	},
/obj/effect/decal/cleanable/blood/footprints,
/obj/effect/decal/cleanable/blood/tracks{
	dir = 1
	},
/turf/open/indestructible/necropolis,
/area/ruin/powered/gluttony)
"ll" = (
/obj/structure/stone_tile/block,
/obj/structure/stone_tile/block/cracked{
	dir = 1
	},
/obj/structure/table/wood,
/obj/item/spear/bonespear,
/obj/item/slime_extract/silver,
/turf/open/indestructible/necropolis,
/area/ruin/powered/gluttony)
"ln" = (
/obj/structure/stone_tile/block,
/turf/open/indestructible/necropolis,
/area/ruin/powered/gluttony)
"ls" = (
/obj/effect/decal/cleanable/blood/footprints{
	dir = 1
	},
/obj/effect/decal/cleanable/blood/tracks{
	dir = 1
	},
/turf/open/indestructible/necropolis,
/area/ruin/powered/gluttony)
"ly" = (
/obj/structure/stone_tile/slab/cracked{
	dir = 4
	},
/turf/open/indestructible/necropolis,
/area/ruin/powered/gluttony)
"nT" = (
/turf/closed/indestructible/riveted/boss,
/area/ruin/powered/gluttony)
"pj" = (
/obj/structure/stone_tile/block/burnt{
	dir = 4
	},
/obj/structure/stone_tile/block/cracked{
	dir = 8
	},
/turf/open/indestructible/necropolis,
/area/ruin/powered/gluttony)
"pr" = (
/obj/structure/headpike/bone,
/turf/open/misc/asteroid/basalt/lava_land_surface/biome_replace,
/area/lavaland/surface/outdoors)
"pD" = (
/obj/structure/stone_tile/center/cracked,
/obj/structure/stone_tile/surrounding/cracked{
	dir = 1
	},
/obj/structure/stone_tile/surrounding/cracked{
	dir = 8
	},
/turf/open/lava/smooth/lava_land_surface,
/area/ruin/powered/gluttony)
"qs" = (
/obj/structure/stone_tile/block/burnt{
	dir = 4
	},
/obj/structure/stone_tile/block/cracked{
	dir = 8
	},
/turf/open/lava/smooth/lava_land_surface,
/area/ruin/powered/gluttony)
"qC" = (
/obj/structure/stone_tile/surrounding/cracked{
	dir = 8
	},
/obj/structure/bonfire/prelit,
/turf/open/indestructible/necropolis,
/area/ruin/powered/gluttony)
"rg" = (
/obj/structure/stone_tile/block/burnt,
/turf/open/indestructible/necropolis,
/area/ruin/powered/gluttony)
"sH" = (
/turf/open/misc/asteroid/basalt/lava_land_surface/biome_replace,
/area/lavaland/surface/outdoors)
"tj" = (
/obj/structure/stone_tile/center/burnt,
/obj/structure/stone_tile/surrounding_tile/burnt{
	dir = 1
	},
/obj/structure/stone_tile/surrounding_tile/burnt{
	dir = 4
	},
/obj/structure/stone_tile/surrounding_tile/burnt{
	dir = 8
	},
/turf/open/misc/asteroid/basalt/lava_land_surface/biome_replace,
/area/lavaland/surface/outdoors)
"vU" = (
/obj/structure/stone_tile/surrounding_tile/burnt{
	dir = 1
	},
/turf/open/indestructible/necropolis,
/area/ruin/powered/gluttony)
"wD" = (
/obj/structure/stone_tile/cracked{
	dir = 8
	},
/turf/open/indestructible/necropolis,
/area/ruin/powered/gluttony)
"wI" = (
/obj/structure/stone_tile/surrounding_tile/cracked{
	dir = 1
	},
/obj/structure/stone_tile/surrounding/cracked,
/obj/structure/stone_tile/center/cracked,
/turf/open/lava/smooth/lava_land_surface,
/area/ruin/powered/gluttony)
"xA" = (
/obj/structure/stone_tile/center/cracked,
/obj/structure/stone_tile/surrounding/cracked{
	dir = 5
	},
/obj/structure/headpike/bone,
/turf/open/lava/smooth/lava_land_surface,
/area/ruin/powered/gluttony)
"yx" = (
/obj/structure/stone_tile/block,
/obj/structure/stone_tile/block/cracked{
	dir = 1
	},
/obj/structure/table/wood,
/obj/item/food/meat/slab/goliath,
/obj/item/food/meat/slab/human/mutant/ethereal,
/turf/open/indestructible/necropolis,
/area/ruin/powered/gluttony)
"zd" = (
/obj/structure/stone_tile/block/burnt{
	dir = 4
	},
/turf/open/indestructible/necropolis,
/area/lavaland/surface/outdoors)
"zr" = (
/obj/structure/stone_tile/block/burnt{
	dir = 8
	},
/obj/structure/stone_tile,
/turf/open/indestructible/necropolis,
/area/ruin/powered/gluttony)
"Av" = (
/obj/effect/decal/cleanable/blood/footprints{
	dir = 4
	},
/obj/effect/decal/cleanable/blood/tracks{
	dir = 5
	},
/turf/open/indestructible/necropolis,
/area/ruin/powered/gluttony)
"Ci" = (
/obj/structure/stone_tile/block/cracked{
	dir = 8
	},
/turf/open/indestructible/necropolis,
/area/ruin/powered/gluttony)
"Ck" = (
/obj/structure/stone_tile/slab/cracked,
/turf/open/misc/asteroid/basalt/lava_land_surface,
/area/ruin/powered/gluttony)
"CM" = (
/obj/structure/stone_tile/block,
/obj/structure/stone_tile/block/cracked{
	dir = 1
	},
/obj/effect/decal/cleanable/blood/gibs/torso,
/turf/open/indestructible/necropolis,
/area/ruin/powered/gluttony)
"Dk" = (
/obj/structure/stone_tile/block/burnt{
	dir = 8
	},
/obj/structure/stone_tile/surrounding_tile/cracked{
	dir = 1
	},
/turf/open/misc/asteroid/basalt/lava_land_surface/biome_replace,
/area/lavaland/surface/outdoors)
"DB" = (
/obj/structure/stone_tile/slab/burnt,
/turf/open/indestructible/necropolis,
/area/lavaland/surface/outdoors)
"DY" = (
/obj/structure/stone_tile/center/burnt,
/obj/structure/stone_tile/surrounding/cracked{
	dir = 6
	},
/turf/open/indestructible/necropolis,
/area/lavaland/surface/outdoors)
"Eq" = (
/obj/structure/stone_tile/surrounding_tile/burnt,
/obj/structure/stone_tile/center/burnt,
/turf/open/indestructible/necropolis,
/area/ruin/powered/gluttony)
"ED" = (
/turf/open/indestructible/necropolis,
/area/ruin/powered/gluttony)
"EN" = (
/obj/structure/stone_tile/center,
/obj/structure/stone_tile/surrounding_tile{
	dir = 4
	},
/obj/structure/stone_tile/surrounding_tile/burnt,
/obj/structure/stone_tile/surrounding_tile/cracked{
	dir = 1
	},
/turf/open/indestructible/necropolis,
/area/lavaland/surface/outdoors)
"Fi" = (
/obj/effect/decal/cleanable/blood/gibs/down,
/turf/open/indestructible/necropolis,
/area/ruin/powered/gluttony)
"Ie" = (
/obj/structure/stone_tile/surrounding_tile/burnt{
	dir = 1
	},
/obj/structure/stone_tile/slab/cracked{
	dir = 1
	},
/obj/effect/mob_spawn/corpse/human/miner,
/obj/item/clothing/gloves/butchering,
/turf/open/indestructible/necropolis,
/area/ruin/powered/gluttony)
"IM" = (
/obj/structure/stone_tile/slab/cracked{
	dir = 10
	},
/obj/structure/stone_tile/surrounding_tile/burnt{
	dir = 1
	},
/obj/effect/decal/cleanable/blood/footprints,
/obj/effect/decal/cleanable/blood/tracks{
	dir = 10
	},
/turf/open/indestructible/necropolis,
/area/ruin/powered/gluttony)
"Lx" = (
/obj/structure/stone_tile/block/burnt{
	dir = 4
	},
/turf/open/misc/asteroid/basalt/lava_land_surface/biome_replace,
/area/lavaland/surface/outdoors)
"LT" = (
/obj/effect/decal/cleanable/blood/footprints,
/obj/effect/decal/cleanable/blood/tracks{
	dir = 1
	},
/obj/effect/decal/cleanable/blood,
/turf/open/indestructible/necropolis,
/area/ruin/powered/gluttony)
"MH" = (
/turf/open/lava/smooth/lava_land_surface,
/area/lavaland/surface/outdoors)
"Ol" = (
/obj/effect/decal/cleanable/blood/footprints{
	dir = 8
	},
/obj/effect/decal/cleanable/blood/tracks{
	dir = 4
	},
/obj/structure/stone_tile/block/cracked,
/turf/open/indestructible/necropolis,
/area/ruin/powered/gluttony)
"OA" = (
/obj/structure/stone_tile/slab/cracked{
	dir = 1
	},
/turf/open/indestructible/necropolis,
/area/ruin/powered/gluttony)
"Pd" = (
/obj/structure/stone_tile/block/cracked{
	dir = 1
	},
/turf/open/indestructible/necropolis,
/area/ruin/powered/gluttony)
"Qr" = (
/obj/structure/stone_tile{
	dir = 1
	},
/obj/structure/stone_tile/cracked{
	dir = 8
	},
/obj/structure/stone_tile,
/obj/structure/stone_tile{
	dir = 4
	},
/obj/effect/mob_spawn/corpse/human/charredskeleton,
/obj/structure/bonfire/dense,
/turf/open/indestructible/necropolis,
/area/ruin/powered/gluttony)
"Rf" = (
/obj/structure/stone_tile/slab/cracked{
	dir = 5
	},
/turf/open/indestructible/necropolis,
/area/ruin/powered/gluttony)
"Rz" = (
/turf/open/indestructible/necropolis,
/area/lavaland/surface/outdoors)
"Sr" = (
/obj/structure/stone_tile/block/burnt{
	dir = 1
	},
/turf/open/indestructible/necropolis,
/area/ruin/powered/gluttony)
"Tg" = (
/obj/structure/stone_tile/center/burnt,
/obj/structure/stone_tile/surrounding_tile/cracked{
	dir = 4
	},
/obj/structure/stone_tile/surrounding/cracked{
	dir = 1
	},
/turf/open/misc/asteroid/basalt/lava_land_surface/biome_replace,
/area/lavaland/surface/outdoors)
"UG" = (
/obj/structure/stone_tile/block{
	dir = 4
	},
/obj/structure/stone_tile/block/cracked{
	dir = 8
	},
/turf/open/indestructible/necropolis,
/area/ruin/powered/gluttony)
"UH" = (
/obj/structure/stone_tile/slab/burnt,
/turf/open/indestructible/necropolis,
/area/ruin/powered/gluttony)
"Vc" = (
/obj/structure/stone_tile/slab/cracked,
/turf/open/indestructible/necropolis,
/area/ruin/powered/gluttony)
"Vz" = (
/obj/effect/decal/cleanable/blood/footprints{
	dir = 8
	},
/obj/structure/stone_tile/surrounding_tile/burnt,
/turf/open/indestructible/necropolis,
/area/ruin/powered/gluttony)
"Wy" = (
/obj/structure/stone_tile{
	dir = 4
	},
/obj/structure/stone_tile/cracked{
	dir = 8
	},
/obj/structure/table/wood,
/obj/item/food/meat/slab/human/mutant/moth,
/turf/open/indestructible/necropolis,
/area/ruin/powered/gluttony)
"WR" = (
/turf/closed/mineral/volcanic/lava_land_surface/biome_replace,
/area/lavaland/surface/outdoors)
"XY" = (
/obj/effect/decal/cleanable/blood/footprints,
/turf/open/indestructible/necropolis,
/area/ruin/powered/gluttony)
"YG" = (
/obj/structure/stone_tile/block/burnt{
	dir = 4
	},
/obj/effect/decal/cleanable/blood/tracks{
	dir = 10
	},
/turf/open/indestructible/necropolis,
/area/ruin/powered/gluttony)
"Zd" = (
/obj/effect/decal/cleanable/blood/tracks{
	dir = 9
	},
/obj/structure/stone_tile/block,
/turf/open/indestructible/necropolis,
/area/ruin/powered/gluttony)
"Zx" = (
/obj/structure/stone_tile/surrounding/cracked,
/obj/structure/bonfire/prelit,
/turf/open/indestructible/necropolis,
/area/ruin/powered/gluttony)
"ZT" = (
/obj/structure/stone_tile{
	dir = 4
	},
/obj/structure/stone_tile/cracked{
	dir = 8
	},
/obj/structure/stone_tile/cracked{
	dir = 1
	},
/obj/structure/stone_tile,
/obj/structure/bonfire/prelit,
/turf/open/lava/smooth/lava_land_surface,
/area/ruin/powered/gluttony)
"ZV" = (
/obj/structure/stone_tile/block,
/obj/structure/stone_tile/block/cracked{
	dir = 1
	},
/turf/open/indestructible/necropolis,
/area/ruin/powered/gluttony)

(1,1,1) = {"
sH
WR
WR
WR
WR
sH
sH
sH
sH
sH
sH
sH
sH
sH
"}
(2,1,1) = {"
sH
sH
sH
sH
sH
sH
sH
sH
nT
jM
jM
jM
sH
sH
"}
(3,1,1) = {"
sH
sH
jM
jM
jM
nT
jM
jM
jM
ED
ie
nT
sH
sH
"}
(4,1,1) = {"
sH
sH
jM
ZT
UG
Vc
qs
UH
pj
Vc
ED
nT
MH
sH
"}
(5,1,1) = {"
sH
sH
nT
CM
Zd
XY
LT
bD
kB
IM
Vc
jM
MH
MH
"}
(6,1,1) = {"
sH
MH
nT
ln
Ol
Wy
eb
nT
zr
Av
YG
jM
MH
MH
"}
(7,1,1) = {"
sH
MH
nT
ZV
eq
nT
nT
nT
wI
rg
Ie
jM
MH
sH
"}
(8,1,1) = {"
sH
MH
MH
ly
Vz
Ck
xA
ED
nT
nT
nT
nT
sH
sH
"}
(9,1,1) = {"
sH
MH
nT
ll
iw
ls
ls
eN
vU
Rz
MH
MH
pr
sH
"}
(10,1,1) = {"
sH
sH
jM
dI
OA
Fi
nT
OA
Pd
EN
gg
gg
Dk
sH
"}
(11,1,1) = {"
sH
sH
nT
yx
Rf
Vc
nT
UH
Pd
DB
aE
DY
tj
sH
"}
(12,1,1) = {"
sH
sH
nT
ZV
UH
pD
Ck
Eq
Sr
fY
zd
Lx
Tg
sH
"}
(13,1,1) = {"
sH
sH
nT
Qr
bv
Ci
wD
aO
fa
MH
MH
MH
pr
sH
"}
(14,1,1) = {"
sH
sH
jM
nT
MH
MH
Zx
qC
MH
MH
MH
MH
sH
sH
"}
(15,1,1) = {"
sH
sH
sH
sH
sH
MH
MH
MH
MH
MH
MH
sH
sH
WR
"}
(16,1,1) = {"
WR
sH
sH
sH
sH
sH
sH
sH
sH
sH
sH
sH
WR
WR
"}
